Name:
Test Level
Light:
0
Skybox:
deathvalley_panorama.jpg
WallTextures:
01: wall_texture.jpg
WallGrid:
01010101010101010101
01010000000000000001
01000000000000000001
01000000010000000001
01000000010000000001
01000000010101010001
01000000000000000001
01000100000000000001
01000000000000000001
01010101010101010101